               
 i----L i----L 
 |    | |    | 
 |    | |    | 
 |    | |    | 
 |    | |    | 
 I----+-+----l 
      | |      
------+-+----L 
      | |    | 
      | |    | 
      | |    | 
      | |    | 
      | I----l 
      |        