               
 i----L i----L 
 |    | |    | 
 | ff | | ff | 
 | ff | | ff | 
 |    | |    | 
 I----+-+----l 
      | |      
------+-+----L 
      | |    | 
      | | ff | 
  epe | | ff | 
      | |    | 
      | I----l 
      |        