               
     i-------L 
     |       | 
   K-+-r  s  | 
   | | |     | 
---+-+-+-----l 
   | |1|       
---+-+-R i---L 
   | |   |   | 
   | |   |   | 
   k-+---R   | 
     |       | 
     |   s   | 
     I-------l 
               