               
     i-------L 
     |       | 
   K-+-r     | 
   | | |     | 
---+-+-+-----l 
   | | |       
---+-+-R i---L 
   | |   |   | 
   | |   |   | 
   k-+---R   | 
     |       | 
     |       | 
     I-------l 
                