               
     i-------L 
     |       | 
   K-+-r  1  | 
   | | |     | 
---+-+-+-----l 
   | |s|       
---+-+-R i---L 
   | |   |   | 
   | |   |   | 
   k-+---R   | 
     |       | 
     |   s   | 
     I-------l 
               