               
     i-------L 
     |       | 
   K-+-r  12 | 
   | | |     | 
---+-+-+-----l 
   | |s|       
---+-+-R i---L 
   | |   |   | 
   | |   |   | 
   k-+---R   | 
     |       | 
     |       | 
     I-------l 
               