               
---r           
   |           
 i-R K-------r 
 |   |       | 
 I-r |   s   | 
   | |       | 
 i-R |       | 
 |   k---T---R 
 I-r     |     
   |  1  |     
 i-R  i--t---L 
 |    |     s| 
 I----+------l 
      |        