               
---r           
   |           
 i-R K-------r 
 |   |       | 
 I-r |       | 
   | |       | 
 i-R |       | 
 |   k---T---R 
 I-r     |     
   |     |     
 i-R  i--t---L 
 |    |      | 
 I----+------l 
      |        