 |         |   
 | i-L  1  |   
 | | |     |   
 I-+-l i-L |   
   |   | | |   
 K-+---+-l |   
 | |   |   |   
 k-R i-+-L |   
     | | | |   
     | I-l |   
     |  p  |   
   K-+-----+-r 
   | |     | | 
   k-R     k-R 
               