 |         |   
 | l-l     |   
 | | |     |   
 l-+-l l-l |   
   |   | | |   
 r-+---+-l |   
 | |   |   |   
 r-r l-+-l |   
     | | | |   
     | l-l |   
     |     |   
   r-+-----+-r 
   | |     | | 
   r-r     r-r 
               