         K---r      
 i---L i-+-L | i--L 
 |   | | | | | |  | 
 | K-+-+-+-l | Ir | 
 | | | | |   |  | | 
 I-l | I-l K-+--+-l 
     |     | |  |   
  K--l K-r k-R  I-r 
  |    | |        | 
  k----+-R iL K---+-
       |   || |   | 
 K--r  | i-Rk-+-L | 
 |  |  | |    | | | 
 |  I--l I----l k-R 
 |                  