         r---r      
 l---l l-+-l | l--l 
 |   | | | | | |  | 
 | r-+-+-+-l | lr | 
 | | | | |   |  | | 
 l-l | l-l r-+--+-l 
     |     | |  |   
  r--l r-r r-r  l-r 
  |    | |        | 
  r----+-r ll r---+-
       |   || |   | 
 r--r  | l-rr-+-l | 
 |  |  | |    | | | 
 |  l--l l----l r-r 
 |                  