               
     i-------L 
     |       | 
   r-+-R     | 
   | | |     | 
---+-+-+-----l 
   | | |       
---+-+-k i---L 
   | |   |   | 
   | |   |   | 
   K-+---k   | 
     |       | 
     |  t    | 
     I-------l 
               