               
     l-------l 
     |       | 
   r-+-r     | 
   | | |     | 
---+-+-+-----l 
   | | |       
---+-+-r l---l 
   | |   |   | 
   | |   |   | 
   r-+---r   | 
     |       | 
     |       | 
     l-------l 
               