               
     r-------r 
     |       | 
   l-+-l     | 
   | | |     | 
---+-+-+-----r 
   | | |       
---+-+-l r---r 
   | |   |   | 
   | |   |   | 
   l-+---l   | 
     |       | 
     |       | 
     r-------r 
               