               
     i-------L 
     |   eee | 
   K-+-r e1e | 
   | | | eee | 
---+-+-+-----l 
   | | |       
---+-+-R i---L 
   | |eee|   | 
   | |ese|   | 
   k-+---R   | 
     |       | 
     |       | 
     I-------l 
               