               
     i-------L 
     |       | 
   K-+-r  12 | 
   | | |     | 
---+-+-+-----l 
   | | |       
---+-+-R i---L 
   | |   |   | 
   | | s |   | 
   k-+---R   | 
     |       | 
     |       | 
     I-------l 
               