       |       
 K-----+-----r 
 |     |     | 
 |     |  2  | 
 |  K--+--r  | 
 |  |  |  |  | 
 |  |  |  |  | 
 |  |  k--R  | 
 |  |        | 
 |  |   1    | 
 |  k--------R 
 |             
 |             
 k-------------
               