       |       
 K-----+-----r 
 |     |     | 
 |     |     | 
 |  K--+--r  | 
 |  |  |  |  | 
 |  |  |  |  | 
 |  |  k--R  | 
 |  |        | 
 |  |        | 
 |  k--------R 
 |             
 |             
 k-------------
               