       |       
 K-----+-----r 
 |     |     | 
 |     |     | 
 |  K--+--r  | 
 |  |  |  |  | 
 |  |  |  |  | 
 |  |  k--R  | 
 |  |   1    | 
 |  |        | 
 |  k--------R 
 |             
 | 2           
 k-------------
               