       |       
 K-----+-----r 
 |     |     | 
 |     |   1 | 
 |  K--+--re | 
 |  |  |  |  | 
 |  |  |  |  | 
 |  |  k--R  | 
 |  |1       | 
 |  |        | 
 | ek--------R 
 |e2e            
 |eee            
 k-------------
               