     |         
---rK+----r    
   |||    |    
 i-Rk+L K-+--r 
 |   || | |  | 
 I---+l k-R  | 
     |2      | 
     |   1   | 
--T--+---T---+-
  |  |   |   | 
  |  k---+---R 
  |      |     
--t------R     
               
               