     |         
---rK+----r    
   ||| 1  |    
 i-Rk+L K-+--r 
 |   || | |  | 
 I---+l k-R  | 
     |       | 
     |   1   | 
--T--+---T---+-
  |  |   |   | 
  |  k---+---R 
  |  s   |     
--t------R     
               
               