     |         
---rK+----r    
   |||    |    
 i-Rk+L K-+--r 
 |   || | |  | 
 I---+l k-R  | 
     |1      | 
     |       | 
--T--+---T---+-
  |  |   |1  | 
  |  k---+---R 
  |  s   |     
--t------R     
               
               