  |            
 iR            
 |        K--r 
 Ir   1   |  | 
  |       |  | 
 iR K---r |  | 
 |  |   | |  | 
 Ir |   I-l  | 
  | |        | 
 iR k---L    | 
 |      |    | 
 I------l  1 | 
             | 
-------------R 
               