  |            
 lr            
 |        r--r 
 lr       |  | 
  |       |  | 
 lr r---r |  | 
 |  |   | |  | 
 lr |   l-l  | 
  | |        | 
 lr r---l    | 
 |      |    | 
 l------l    | 
             | 
-------------r 
               