  |            
 iR            
 |        K--r 
 Ir       |  | 
  |       |  | 
 iR K---r |  | 
 |  |   | |  | 
 Ir |   I-l  | 
  | |        | 
 iR k---L    | 
 |      |    | 
 I------l    | 
             | 
-------------R 
               